1111111111
1P01000001
1E01011101
11111C0001
1111111111