1111111111
1001000001
100C011101
1P011E0001
1111111111