1111111111
1P00000001
1E01011101
11111C0001
1111111111