1111111111
1P00000E01
1001C11101
101110C001
1111111111