1111111111
1P00000C01
1001C11101
1E1110C001
1111111111