111111111111111
100010C00C00001
101C001110011C1
1P111E0000C1001
111111111111111