111111111111111
100100000000001
100C01111111001
1P011E000000001
111111111111111