11111111111111111111
10010000000000000001
10010000000000000001
10010000000000000001
10010000000000000001
10010000000000000001
100C0111111111111001
1P011E00000000000001
11111111111111111111