11111111111111111111
100C01C00C0000000001
10011110001001110101
10000000111011C001C1
111100111C1000010111
10C10000001000110C01
10110111100110111111
1P0001C0001110C000E1
11111111111111111111