1110011111111
1001000000001
100C011111001
1P0011E000001
1111100111111