1111111111111
100100000C001
111C011111001
1P1011E000001
1111111111111