1111111111111
100100E00C001
100C011111001
1P0011E000001
1111111111111