1111110001111111
100100000C001
100C011111001
1P0011E001
1111001