1111111111
1P000010E1
1011101101
100C1000C1
1110110111
1C00000001
10111101C1
1000000101
10C1100001
1111111111