1111111111111
100100000C001
100C011111001
1P0011E000001
1111111111111